AVAPPL = "Absentee Voting-Application for"
AVBDIS = "Absentee Voting-Distributing Ballots"
AVEVIP = "Absentee Voting-Early Voting/In-Person Absentee"
AVELIG = "Absentee Voting-Eligibility"
AVMIOV = "Absentee Voting-Military/Overseas"
AVMISC = "Absentee Voting-Misc."
AVMOVE = "Absentee Voting-MOVE Act"
AVNOEX = "Absentee Voting-No Excuse"
AVPERM = "Absentee Voting-Permanent Status"
AVBRET = "Absentee Voting-Returning Ballots"
VOTEME = "Alt Voting Methods (Ranked Choice, etc)"
AUDITS = "Audits-Post Election"
BACAND = "Ballot Access-Candidates"
BAPART = "Ballot Access-Parties"
BALDES = "Ballots-Format & Design"
CANQUL = "Candidates-Qualifications for Office"
CANRTR = "Candidates-Resign to Run"
CANWDW = "Candidates-Withdrawal/Death"
CANWRI = "Candidates-Write-in"
VTRCHA = "Challenges to Voters"
CNTEST = "Contests"
ELCOST = "Cost of Elections"
VCOUNT = "Counting Votes"
CYBSEC = "Cybersecurity"
ELDATE = "Dates of Elections"
PTDRES = "DREs-Paper Trail"
CRIMES = "Election Crimes"
DATART = "Election Data-Collection/Retention of"
EDHOLI = "Election Day Holiday"
EOCAMP = "Election Officials-Campaign Activities"
EOLOCA = "Election Officials-Local"
EOSTWD = "Election Officials-Statewide"
REPRES = "Election Results/Canvass, Reporting of"
ELEING = "Electioneering"
ELECOL = "Electoral College"
ECONPV = "Electoral College-National Popular Vote"
EMEDIS = "Emergencies/Disasters"
EXPOLL = "Exit Polling"
DUALFU = "Fusion/Dual-Party"
INVOTE = "Internet Voting"
MAILVO = "Mail Voting"
MISCEL = "Miscellaneous"
FILING = "Offices-Method of Filling"
POLPAR = "Political Parties"
POLWAT = "Poll Watchers"
PWCOMP = "Poll Workers-Compensation"
PWMISC = "Poll Workers-Misc."
PWQUAL = "Poll Workers-Selection/Qualifications of"
PWTRAI = "Poll Workers-Training"
PWYOTH = "Poll Workers-Youth"
PPPROC = "Polling Places-Arrangement of/Procedures at"
PPACES = "Polling Places-Disabled Access"
PPVHRS = "Polling Places-Hours"
PPLOCA = "Polling Places-Locations"
PPVCEN = "Polling Places-Vote Centers"
PREDEF = "Precinct Definition"
PRIDAT = "Primaries-Dates"
PRIMIS = "Primaries-Misc."
PRIPUS = "Primaries-Presidential"
PRIRNF = "Primaries-Runoff"
PRITYP = "Primaries-Types"
PROVOT = "Provisional Voting"
RECOUN = "Recounts"
REGDRI = "Registration Drives"
REGAPP = "Registration-Application Form/Content"
REGATO = "Registration-Automatic"
REGCVL = "Registration-Centralized Voter List"
REGDTE = "Registration-Deadline"
REGEDY = "Registration-Election Day"
REGELE = "Registration-Electronic"
REGIDR = "Registration-ID Required"
REGLST = "Registration-List Maintenance"
REGMSC = "Registration-Misc."
REGPRE = "Registration-Preregistration"
REGSDL = "Registration-Sale/Distribution/Use of Lists"
RUNOFF = "Run-Off Elections"
SPELEC = "Special Elections"
STVOTE = "Straight Ticket Voting"
TFSCIC = "Task Forces/Study Commissions/Interim Committees"
VACNCY = "Vacancies"
VEDINF = "Voter Education/Information"
VOTRID = "Voter Identification"
VOTAFW = "Voters-Absence from Work"
VOTAGE = "Voters-Age"
VOTAST = "Voters-Assistance to"
VOTFVR = "Voters-Felon Voting Rights"
VOTMQU = "Voters-Miscellaneous Qualifications"
TECHSS = "Voting Equipment/Technology-Selection & Standards"
VSSCST = "Voting System Testing/Security/Storage"
